##########################################################################
#######################################         ###            ###########
    ########################################################## ###########
### ###########                  ############################# ###########
### ########################################################## ###########
### ###################################         ############## ###########
### #########################################################   ##########
###        ############################         ############# # ##########
### ######################################################### # ##########
### ###########                  ########################     #     ######
### ##################################################### ### # ### ######
### ###################################         ######### ### # ### ######
###         ##############################################################
### ################################################   ####  ###  ###  ###
### ###########                                   ########################
### ############################### #############             ############
### ############################### ######################### ############
### ############################### ######################### ############
### ###############################               ########### ############
### ############################################# ########### ############
###                 ############################# ##########         #####
################### ############################# ########## ####### #####
######        ##### ######                        ########## ####### #####
###### ############ #############################                    #####
###### ############ ######################################################
######        ##### ######################################################
###################                                      #################
######################################################## #################
########################################################           #      
##########################################################################