##########################################################################
#########################################################             ####
                                                       ## ########### ####
# ####################################################### ########### ####
# ########                                                            ####
# ####################################################### ########### ####
# ##############################              ########### ########### ####
# #### ######################### ############ ########### ########### ####
# #### ######################### ############ ########### ########### ####
# #### ######################### ############ ########### ########### ####
# #### ################  ####### ##                                   ####
# #### ######################### ## ################################# ####
# ####           ############### ## ################################# ####
# ############## ############### ## ################################# ####
# #              ############### ## #######    ##########  ########## ####
# ############## ############### #######    ######################### ####
# #              ############### ##########    ##########  ########## ####
# ############## #######       # #################################### ####
# ############## ############# # #################################### ####
# #                            # #################################### ####
# ############## ############### ##### ######## ######### ######### # ####
# ############## ############### ##### ######## ######### ######### # ####
# ############## ############### ##### ######## ######### ######### # ####
# ############## ############### ##### ######## ######### ######### # ####
# ############## ############### ##### ######## ######### ######### # ####
# ############## ###############                                    # ####
# ##############               ###################################### ####
# ################################################################### ####
#                                                                         
##########################################################################